5 9
INNNNNNNI
NNNNNNNNN
DDDDDDDDD
NNNNNNNNN
INNNNNNNI

