6 10
IIIIIIIIII
IDDDDDDDDI
IDNENENEDI
IDNENENEDI
IDDDDDDDDI
IIIIIIIIII

